# map version name
map 8 map_overworld

# tile_defs count [anim material auto_tile_mask]
tile_defs 15
gfx_anim_til_void          mat_void       0
gfx_anim_til_stone_path    mat_stone_path 0
gfx_anim_til_water_dark    mat_water      0
gfx_anim_til_grass_weeds   mat_grass      0
gfx_anim_til_grass_flowers mat_grass      0
gfx_anim_til_stone_wall_tl mat_stone_wall 0
gfx_anim_til_stone_wall_tc mat_stone_wall 0
gfx_anim_til_stone_wall_tr mat_stone_wall 0
gfx_anim_til_tiny_tree     mat_tiny_tree  0
gfx_anim_til_stone_wall_cl mat_stone_wall 0
gfx_anim_til_stone_wall_cc mat_stone_wall 0
gfx_anim_til_stone_wall_cr mat_stone_wall 0
gfx_anim_til_stone_wall_bl mat_stone_wall 0
gfx_anim_til_stone_wall_bc mat_stone_wall 0
gfx_anim_til_stone_wall_br mat_stone_wall 0

# tiles width height [indices]
tiles 64 64
 5   3   3   5   3   3   5   5   5   5   3   3   3   3   3   3   3   3   3   3   3   3   3   3   3   5   5   5   5   5   5   5   5   3   3   3   3   3   3   3   3   3   3   3   3   3   3   3   3   3   3   3   3   3   1   1   3   3   3   3   3   3   3   3
 3   5   5   5   5   3   5   3   3   5   5   5   3   3   3   3   3   3   3   3   3   3   5   5   5   5   5   5   5   5   5   5   5   5   3   3   3   3   3   3   3   3   3   3   3   3   3   3   3   1   4   1   1   1   1   1   3   3   3   3   3   3   3   3
 5   3   5   3   5   5   5   5   5   5   3   5   3   3   3   3   3   3   3   5   5   5   5   5   5   5   5   5   5   5   5   5   5   5   5   3   3   3   3   3   3   3   3   3   3   3   3   1   1   4   1   1   1   3   3   1   3   3   1   3   3   3   3   3
 3   5   5   5   5   5   5   5   5   3   5   5   3   3   3   3   3   3   3   2   2   2   2   2   2   2   2   2   2   2   2   2   2   5   5   5   3   3   3   3   3   3   3   3   3   3   3   1   1   1   1   1   1   3   3   1   1   4   1   1   3   3   3   3
 5   3   5   5   5   5   5   5   3   3   3   5   3   3   3   3   2   2   2   2   2   2   2   2   2   2   2   2   2   2   2   2   2   2   2   5   3   3   3   3   3   3   3   3   3   3   3   3   1   1   1   3   3   3   3   3   3   1   1   1   3   3   3   3
 5   5   5   5   5   3   5   5   3   3   3   5   3   3   2   2   2   2   2   2   2   2   2   2   2   2   2   2   2   2   2   2   2   2   2   2   2   3   3   3   3   3   3   3   3   3   3   3   1   1   1   3   3   3   3   3   3   3   1   1   1   3   3   3
 3   5   3   5   3   5   5   3   3   3   5   5   5   2   2   2   2   2   2   2   2   2   2   2   2   2   2   2   2   2   2   2   2   2   2   2   2   3   3   3   3   3   3   3   3   3   3   3   1   1   1   4   3   3   3   3   1   1   1   1   1   3   3   3
 3   5   3   5   3   5   5   3   3   3   3   3   2   2   2   2   2   2   2   2   2   2   2   2   3   4   3   3   3   2   2   2   2   2   2   2   2   2   3   3   3   5   6   6   6   7   3   3   1   1   1   4   4   3   3   3   1   4   1   3   1   1   3   3
 5   5   5   5   5   3   3   3   3   3   3   3   2   2   2   2   2   2   2   2   2   3   4   3   3   3   3   3   3   3   4   3   2   2   2   2   2   2   3   3   3  16   7   7   7  18   3   3   3   1   1   1   1   1   1   1   1   1   3   3   4   1   3   3
 3   5   5   5   3   3   3   3   3   3   3   3   2   2   2   2   2   2   2   2   1   1   3   3   3   3   3   3   3   3   3   3   3   2   2   2   2   2   2   3   3  16   7   7   7  18   3   3   3   3   1   1   1   1   1   1   3   3   3   3   1   1   3   3
 3   5   3   3   3   3   3   3   5   5   5   2   2   2   2   2   2   2   2   1   1   1   1   3   3   3   3   3   3   3   3   3   4   2   2   2   2   2   2   3   3   3   3   3   3   3   3   3   3   3   1   6   6   1   3   3   3   3   3   3   1   1   3   3
 3   5   3   3   3   3   3   5   5   2   2   2   2   2   2   2   2   2   2   1   1   3   3   3   3   3   3   3   3   3   3   3   3   3   2   2   2   2   2   3   3   3   3   3   3   3   3   3   3   3   4   0   0   1   4   4   3   3   3   3   1   1   3   3
 5   5   3   3   3   3   5   5   2   2   2   2   2   2   2   2   2   2   2   3   3   3   3   4   3   3   3   3   3   3   3   1   1   4   2   2   2   2   2   3   3   3   3   3   3   3   3   3   3   3   1   0   0   4   1   4   1   3   1   1   1   1   3   3
 3   3   3   3   3   5   5   2   2   2   2   2   2   2   2   2   2   2   2   1   3   4   3   3   3   3   3   3   3   3   3   3   1   1   1   1   1   1   1   1   1   3   3   3   3   3   3   3   3   3   1   6   6   4   1   1   1   3   3   1   1   3   3   3
 3   3   3   3   3   5   2   2   2   2   2   2   2   2   2   2   2   2   2   2   1   3   3   3   3   3   4   3   3   4   3   3   3   1   7   7   7   7   1   3   1   1   3   3   3   3   3   3   3   3   3   6   6   1   1   1   1   1   3   1   1   3   3   3
 3   3   3   3   5   5   2   2   2   2   2   2   2   2   2   2   2   2   2   2   2   1   1   1   1   1   3   3   3   3   1   1   1   2   2   2   2   2   2   3   3   1   1   3   3   3   3   3   3   3   3   6   6   6   6   5   1   1   1   1   1   3   3   3
 3   3   3   3   5   5   2   2   2   2   2   2   2   2   2   2   2   2   2   2   2   2   2   2   2   2   1   1   1   1   2   2   2   2   2   2   2   2   2   1   3   3   1   1   3   3   3   3   3   3   3   6   3   6   5   1   1   1   4   1   3   3   3   3
 3   3   3   3   5   5   2   2   2   2   2   2   2   2   2   2   2   2   2   2   2   2   2   2   2   2   2   2   2   2   2   2   2   2   2   2   2   2   2   2   1   3   1   1   3   3   3   3   3   3   6   3   6   3   1   1   5   1   1   1   3   3   3   3
 3   3   3   3   5   5   2   2   2   2   2   2   2   2   2   2   2   5   2   2   2   2   2   2   2   2   2   2   2   2   2   2   2   2   2   2   2   2   2   2   2   3   1   3   1   3   3   3   3   3   3   6   6   3   6   3   1   1   1   1   3   3   3   3
 3   3   3   5   5   2   2   2   2   2   2   2   2   2   2   2   5   5   1   1   1   5   2   2   2   2   2   2   2   2   2   2   2   2   2   2   2   2   2   2   2   3   3   1   1   3   3   3   3   3   3   3   3   6   3   6   3   3   1   1   3   3   3   3
 3   3   3   5   5   2   2   2   2   2   2   2   2   2   2   1   1   1   1   1   1   5   2   2   2   2   2   2   2   2   2   2   2   2   2   2   2   2   2   2   2   3   1   1   1   3   3   3   3   3   3   3   6   3   6   1   1   1   1   1   3   1   3   3
 3   3   3   5   2   2   2   2   2   2   2   2   2   2   2   1   1   1   1   1   1   5   2   2   2   2   2   2   2   2   2   2   2   2   2   2   2   2   2   2   2   3   1   1   3   3   3   3   3   3   3   3   3   3   1   1   1   1   1   1   3   1   1   1
 3   3   3   2   2   2   2   2   2   2   2   2   2   2   2   5   1   5   1   1   1   5   2   2   2   2   2   2   2   2   2   2   2   2   2   2   2   2   2   2   2   3   1   3   1   3   3   3   3   3   3   3   3   1   1   1   1   1   1   1   1   1   1   1
 3   3   3   2   2   2   2   2   2   2   2   2   2   2   2   2   5   1   1   1   5   5   2   2   2   2   2   2   2   2   2   2   2   2   2   2   2   2   2   2   3   3   1   1   1   3   3   3   3   3   3   3   1   1   1   3   3   4   3   4   1   1   1   1
 3   3   3   2   2   2   2   2   2   2   2   2   2   2   2   2   2   2   2   5   5   2   2   2   2   2   2   2   2   2   2   2   2   2   2   2   2   2   2   2   3   3   1   1   3   3   3   3   3   3   3   1   1   1   1   3   3   3   3   3   4   4   1   1
 3   3   3   2   2   2   2   2   2   2   2   2   2   2   2   2   2   2   2   2   2   2   2   2   2   2   2   2   2   2   2   2   2   2   2   2   2   2   2   3   3   3   1   1   3   3   3   3   3   3   1   1   1   1   1   3   3   4   3   3   4   3   1   1
 3   3   3   3   2   2   2   2   2   2   2   2   2   2   2   2   2   2   2   2   2   2   2   2   2   2   2   2   2   2   2   2   2   2   2   2   2   2   3   3   3   1   1   1   3   3   3   3   3   3   1   1   1   1   1   3   3   3   3   3   4   3   1   1
 3   3   3   3   3   2   2   2   2   2   2   2   2   2   2   2   2   2   2   2   2   2   2   2   2   2   2   2   2   2   2   2   2   2   2   2   3   3   3   3   3   1   1   1   3   3   3   3   3   3   1   1   1   1   3   3   3   3   3   3   3   3   1   1
 3   3   3   3   3   3   2   2   2   2   2   2   2   2   2   2   2   2   2   2   2   2   2   2   2   2   2   2   3   3   2   2   3   3   3   3   3   3   3   3   3   1   3   3   3   3   3   3   3   1   1   1   1   3   3   3   1   3   3   3   3   1   1   3
 3   3   3   3   3   3   3   3   3   3   3   3   3   3   2   2   2   2   2   2   2   2   2   2   3   3   3   3   3   3   3   3   3   3   3   3   3   3   3   1   1   1   3   3   3   3   3   3   3   1   1   1   1   3   3   1   1   3   1   3   3   1   1   3
 3   3   3   3   3   3   3   3   3   3   3   3   3   3   3   3   3   3   3   3   3   3   3   3   3   3   3   3   3   3   3   3   3   3   3   3   3   3   1   1   1   1   3   3   3   3   3   3   1   1   1   1   3   3   3   1   3   3   1   3   1   1   3   3
 3   3   3   3   3   3   3   3   3   3   3   3   3   3   3   3   3   3   3   3   3   3   3   3   3   3   3   3   3   3   3   3   3   3   3   3   3   3   1   3   1   3   3   3   3   3   3   3   1   1   1   1   3   3   3   3   3   3   1   1   1   1   3   3
 3   3   3   3   3   3   3   3   3   3   3   3   3   3   3   3   3   3   3   3   3   3   3   3   3   3   3   3   3   3   3   3   3   3   3   3   3   1   1   1   1   3   3   3   3   3   3   1   1   1   1   3   3   3   1   3   3   1   1   1   1   3   3   3
 3   3   3   3   3   3   3   3   3   3   3   3   3   3   3   3   3   3   3   3   3   3   3   3   3   3   3   3   3   3   3   3   3   3   3   3   1   1   3   1   3   3   3   3   3   3   1   1   1   3   3   3   3   3   3   3   3   3   1   4   1   3   3   3
 3   3   3   3   3   3   3   3   3   3   3   3   3   3   3   3   3   3   3   3   3   3   3   3   1   1   1   1   1   1   3   3   3   3   3   3   1   1   1   1   3   3   3   3   3   1   1   1   3   3   3   3   3   3   1   3   3   3   3   1   1   3   3   3
 3   3   3   3   3   3   3   3   3   3   3   3   3   3   3   3   3   3   3   3   1   1   1   1   1   3   3   3   3   1   3   3   3   3   3   3   1   1   1   3   3   3   3   3   1   1   1   3   3   3   3   3   3   3   3   1   1   1   3   1   1   1   3   3
 3   3   3   3   3   3   3   3   3   3   3   3   3   3   3   3   3   3   3   3   1  16   6  18   1   3   3   5   7   1   3   3   3   3   3   3   1   1   3   3   3   3   3   1   1   1   1   3   3   3   1   1   3   3   1   1   3   1   3   3   4   1   3   3
 3   3   3   3   3   3   3   3   3   3   3   5   6   7   3   3   3   3   3   3   1  16  18  18   1   3   3  16  18   1   3   3   3   3   3   3   1   1   3   3   3   3   3   1   1   4   1   3   3   1   1   3   3   3   1   1   3   3   3   3   4   1   3   3
 3   3   3   3   3   3   3   3   3   3   3   7   7   7   3   3   3   3   3   3   1   1   1   1   1   1   1   1   1   1   3   3   3   3   3   3   1   1   3   3   3   3   1   1   1   1   1   3   3   1   4   3   3   4   1   3   3   3   3   3   1   1   3   3
 3   3   3   3   3   3   3   3   3   3  16   7   7   7  18   3   3   3   3   3   3   3   1   3   3   3   3   3   3   1   3   3   3   3   3   3   1   1   3   3   3   3   1   1   1   1   3   3   1   1   3   3   4   1   1   3   3   3   3   3   1   1   3   3
 3   3   3   3   3   3   3   3   3   3  16  18  18  18  18   3   3   3   3   3   3   3   1   3   3   6   6   6   3   1   3   3   3   3   3   3   1   1   3   3   3   3   1   1   1   3   3   3   3   3   3   4   4   1   1   3   4   3   3   3   1   1   3   3
 3   3   3   3   3   3   3   3   3   3   3   1   1   1   3   3   3   5   6   7   3   3   1   3   3  16  18  18   3   1   3   5   7   3   3   3   1   1   3   3   3   1   1   1   3   3   3   1   1   3   3   4   1   1   3   3   3   3   3   1   1   1   1   3
 3   3   3   3   3   3   3   3   3   3   3   1   1   1   1   1   1   1   1   1   1   1   1   1   1   1   1   1   1   1   1   1   1   1   1   1   1   1   3   3   3   1   1   1   3   3   1   1   1   4   4   4   1   3   3   1   3   3   3   1   1   1   1   3
 3   3   3   3   3   3   3   3   3   3   3   1   1   1   1   1   1   1   1   1   1   1   1   1   1   1   1   1   1   1   1   1   1   1   1   1   1   1   3   3   1   1   4   1   3   1   1   1   1   1   1   1   3   3   3   1   3   3   3   3   1   1   1   1
 3   3   3   3   3   3   3   3   3   3   3   1   1   1   3   3   3   3   3   3   3   3   3   3   3   1   3   3   3   3   3   3   3   3   3   3   1   1   3   1   1   1   1   1   1   1   3   3   1   1   1   1   3   3   3   1   4   3   3   3   1   1   1   1
 3   3   3   3   3   3   3   3   3   3   3   1   1   1   3   3   3   3   3   3   3   3   3   3   1   1   1   3   3   3   3   3   3   3   3   3   1   1   3   1   1   1   1   1   1   1   1   3   1   1   4   3   3   3   3   1   1   3   3   3   1   1   1   1
 3   3   3   3   3   3   3   3   3   3   3   1   1   1   3   3   3   3   3   3   3   3   3   1   1   1   1   1   3   3   3   3   3   3   3   3   1   1   3   1   1   1   1   1   4   1   1   3   3   3   3   3   3   3   3   3   1   4   3   3   1   1   1   1
 3   3   3   3   3   3   3   3   3   3   3   1   1   1   1   1   1   1   1   1   1   1   1   1   1   1   1   1   1   1   1   1   1   1   1   1   1   1   3   3   3   1   1   1   1   1   1   1   3   3   3   1   3   3   1   1   1   1   3   3   1   1   1   1
 3   3   3   3   3   3   3   3   3   3   3   1   1   1   1   1   1   1   1   1   1   1   1   1   1   1   1   1   1   1   1   1   1   1   1   1   1   1   3   3   3   3   3   3   3   1   1   3   3   3   3   3   3   3   4   1   1   1   4   3   1   1   1   1
 3   3   3   3   3   3   3   3   3   3   3   1   1   1   3   3   3   3   3   3   3   3   3   3   3   3   3   3   3   3   3   3   3   3   3   3   3   3   3   3   3   3   3   3   3   1   1   3   3   3   3   3   1   3   3   1   1   1   1   1   1   1   1   1
 3   3   3   3   3   3   3   3   3   3   3   1   1   1   3   3   3   3   3   3   3   3   3   3   3   3   3   3   3   3   3   3   3   3   3   3   3   3   3   3   3   3   3   3   3   1   1   3   3   3   1   3   1   3   3   3   3   3   1   1   1   1   1   3
 3   3   3   3   3   3   3   3   3   3   3   1   1   1   3   3   3   3   3   3   3   3   3   3   3   3   3   3   3   3   3   3   3   3   3   3   3   3   3   3   3   3   1   1   3   1   1   3   3   1   1   3   1   3   3   3   3   3   1   1   1   1   1   3
 3   3   3   3   3   3   3   3   3   3   3   3   3   3   3   3   3   3   3   3   3   3   3   3   3   3   3   3   3   3   3   3   3   3   3   3   3   3   3   3   3   1   1   1   1   1   1   1   1   1   1   3   1   3   3   3   1   1   1   1   3   3   3   3
 3   3   3   3   3   3   3   3   3   3   3   3   3   3   3   3   3   3   3   3   3   3   3   3   3   3   3   3   3   3   3   3   3   3   3   3   3   3   3   3   1   1   1   1   1   3   3   3   1   3   3   3   3   3   3   3   1   1   1   3   3   3   3   3
 3   3   3   3   3   3   3   3   3   3   3   3   3   3   3   3   3   3   3   3   3   3   3   3   3   3   3   3   3   3   3   3   3   3   3   3   3   3   3   1   1   1   1   1   1   3   3   3   3   3   1   3   3   3   1   3   1   4   1   3   3   3   3   3
 3   3   3   3   3   3   3   3   3   3   3   3   3   3   3   3   3   3   3   3   3   3   3   3   3   3   3   3   3   3   3   3   3   3   3   3   3   3   3   1   1   1   3   3   3   3   3   3   3   3   3   1   1   1   1   1   1   1   1   3   3   3   3   3
 3   3   3   3   3   3   3   3   3   3   3   3   3   3   3   3   3   3   3   3   3   3   3   3   3   3   3   3   3   3   3   3   3   3   3   3   3   3   3   3   1   1   1   3   3   3   3   3   3   3   3   3   3   3   4   1   1   1   1   3   3   3   3   3
 3   3   3   3   3   3   3   3   3   3   3   3   3   3   3   3   3   3   3   3   3   3   3   3   3   3   3   3   3   3   3   3   3   3   3   3   3   3   3   3   3   1   1   1   1   1   4   1   1   1   3   3   4   1   1   1   3   1   3   3   3   3   3   3
 3   3   3   3   3   3   3   3   3   3   3   3   3   3   3   3   3   3   3   3   3   3   3   3   3   3   3   3   3   3   3   3   3   3   3   3   3   3   3   3   3   1   1   1   1   1   1   1   1   1   1   1   1   1   1   3   3   3   3   3   3   3   3   3
 3   3   3   3   3   3   3   3   3   3   3   3   3   3   3   3   3   3   3   3   3   3   3   3   3   3   3   3   3   3   3   3   3   3   3   3   3   3   3   3   3   1   1   1   1   1   1   1   1   1   1   1   1   1   3   3   3   3   3   3   3   3   3   3
 3   3   3   3   3   3   3   3   3   3   3   3   3   3   3   3   3   3   3   3   3   3   3   3   3   3   3   3   3   3   3   3   3   3   3   3   3   3   3   3   3   3   3   3   3   3   1   1   3   3   1   1   1   3   3   3   3   3   3   3   3   3   3   3
 3   3   3   3   3   3   3   3   3   3   3   3   3   3   3   3   3   3   3   3   3   3   3   3   3   3   3   3   3   3   3   3   3   3   3   3   3   3   3   3   3   3   3   3   3   3   3   3   3   3   3   3   3   3   3   3   3   3   3   3   3   3   3   3
 3   3   3   3   3   3   3   3   3   3   3   3   3   3   3   3   3   3   3   3   3   3   3   3   3   3   3   3   3   3   3   3   3   3   3   3   3   3   3   3   3   3   3   3   3   3   3   3   3   3   3   3   3   3   3   3   3   3   3   3   3   3   3   3
 3   3   3   3   3   3   3   3   3   3   3   3   3   3   3   3   3   3   3   3   3   3   3   3   3   3   3   3   3   3   3   3   3   3   3   3   3   3   3   3   3   3   3   3   3   3   3   3   3   3   3   3   3   3   3   3   3   3   3   3   3   3   3   3

# path_nodes count [x y z wait_for]
path_nodes 20
1312.000000 2464.000000 0.000000 0.000000
1424.000000 2480.000000 0.000000 0.000000
1424.000000 2720.000000 0.000000 0.000000
880.000000 2720.000000 0.000000 0.000000
800.000000 2640.000000 0.000000 3.000000
800.000000 3024.000000 0.000000 0.000000
1488.000000 3024.000000 0.000000 0.000000
1536.000000 2960.000000 0.000000 0.000000
1728.000000 2960.000000 0.000000 0.000000
1776.000000 3024.000000 0.000000 0.000000
2320.000000 3024.000000 0.000000 0.000000
2320.000000 2752.000000 0.000000 0.000000
2048.000000 2704.000000 0.000000 1.000000
1888.000000 2704.000000 0.000000 0.000000
1888.000000 2464.000000 0.000000 0.000000
1488.000000 2464.000000 0.000000 0.000000
1440.000000 2448.000000 0.000000 2.000000
1568.000000 2448.000000 0.000000 0.000000
1568.000000 2272.000000 0.000000 0.000000
1312.000000 2272.000000 0.000000 0.000000

# paths count [node_start node_count]
paths 1
0 20
